accordion	accordion
aircraft	aircraft
airplane	airplane
alpaca	alpaca
ambulance	ambulance
animal	animal
ant	ant
antelope	antelope
apple	apple
armadillo	armadillo
artichoke	artichoke
axe	axe
backpack	backpack
bagel	bagel
ball	ball
balloon	balloon
banana	banana
band-aid	band-aid
banjo	banjo
barge	barge
barrel	barrel
bat	bat
bathtub	bathtub
beaker	beaker
bear	bear
bed	bed
bee	bee
beehive	beehive
beer	beer
beetle	beetle
belt	belt
bench	bench
bicycle	bicycle
bidet	bidet
billboard	billboard
binoculars	binoculars
bird	bird
blender	blender
boat	boat
bomb	bomb
book	book
bookcase	bookcase
boot	boot
bottle	bottle
bowl	bowl
box	box
boy	boy
brassiere	brassiere
bread	bread
briefcase	briefcase
broccoli	broccoli
building	building
bull	bull
burrito	burrito
bus	bus
bust	bust
butterfly	butterfly
cabbage	cabbage
cabinetry	cabinetry
cake	cake
calculator	calculator
camel	camel
camera	camera
canary	canary
candle	candle
candy	candy
cannon	cannon
canoe	canoe
cantaloupe	cantaloupe
car	car
carnivore	carnivore
carrot	carrot
cart	cart
castle	castle
cat	cat
caterpillar	caterpillar
cattle	cattle
cello	cello
centipede	centipede
chainsaw	chainsaw
chair	chair
cheese	cheese
cheetah	cheetah
chicken	chicken
chime	chime
chisel	chisel
chopsticks	chopsticks
clock	clock
closet	closet
clothing	clothing
coat	coat
cocktail	cocktail
coconut	coconut
coffee	coffee
coffeemaker	coffeemaker
coin	coin
container	container
cookie	cookie
cosmetics	cosmetics
couch	couch
countertop	countertop
crab	crab
cream	cream
crocodile	crocodile
croissant	croissant
crown	crown
crutch	crutch
cucumber	cucumber
cupboard	cupboard
curtain	curtain
dagger	dagger
deer	deer
desk	desk
dessert	dessert
diaper	diaper
dice	dice
dinosaur	dinosaur
dishwasher	dishwasher
dog	dog
doll	doll
dolphin	dolphin
door	door
doughnut	doughnut
dragonfly	dragonfly
drawer	drawer
dress	dress
drill	drill
drink	drink
drum	drum
duck	duck
dumbbell	dumbbell
eagle	eagle
earrings	earrings
egg	egg
elephant	elephant
envelope	envelope
eraser	eraser
falcon	falcon
fax	fax
fedora	fedora
fireplace	fireplace
fish	fish
flag	flag
flashlight	flashlight
flower	flower
flowerpot	flowerpot
flute	flute
food	food
football	football
footwear	footwear
fork	fork
fountain	fountain
fox	fox
frog	frog
fruit	fruit
furniture	furniture
giraffe	giraffe
girl	girl
glasses	glasses
glove	glove
goat	goat
goggles	goggles
goldfish	goldfish
gondola	gondola
goose	goose
grape	grape
grapefruit	grapefruit
grinder	grinder
guacamole	guacamole
guitar	guitar
hamburger	hamburger
hammer	hammer
hamster	hamster
handbag	handbag
handgun	handgun
harmonica	harmonica
harp	harp
harpsichord	harpsichord
hat	hat
headphones	headphones
heater	heater
hedgehog	hedgehog
helicopter	helicopter
helmet	helmet
hippopotamus	hippopotamus
honeycomb	honeycomb
horse	horse
house	house
houseplant	houseplant
humidifier	humidifier
insect	insect
invertebrate	invertebrate
ipod	ipod
isopod	isopod
jacket	jacket
jacuzzi	jacuzzi
jaguar	jaguar
jeans	jeans
jellyfish	jellyfish
jug	jug
juice	juice
kangaroo	kangaroo
kettle	kettle
kitchenware	kitchenware
kite	kite
knife	knife
koala	koala
ladder	ladder
ladle	ladle
ladybug	ladybug
lamp	lamp
lantern	lantern
laptop	laptop
lavender	lavender
lemon	lemon
leopard	leopard
lighthouse	lighthouse
lily	lily
limousine	limousine
lion	lion
lipstick	lipstick
lizard	lizard
lobster	lobster
loveseat	loveseat
lynx	lynx
magpie	magpie
mammal	mammal
man	man
mango	mango
maple	maple
maracas	maracas
microphone	microphone
milk	milk
miniskirt	miniskirt
mirror	mirror
missile	missile
mixer	mixer
monkey	monkey
motorcycle	motorcycle
mouse	mouse
muffin	muffin
mug	mug
mule	mule
mushroom	mushroom
nail	nail
necklace	necklace
nightstand	nightstand
oboe	oboe
orange	orange
organ	organ
ostrich	ostrich
otter	otter
oven	oven
owl	owl
oyster	oyster
paddle	paddle
pancake	pancake
panda	panda
parachute	parachute
parrot	parrot
pasta	pasta
pastry	pastry
peach	peach
pear	pear
pen	pen
penguin	penguin
perfume	perfume
person	person
piano	piano
pig	pig
pillow	pillow
pineapple	pineapple
pitcher	pitcher
pizza	pizza
plant	plant
plate	plate
platter	platter
pomegranate	pomegranate
popcorn	popcorn
porch	porch
porcupine	porcupine
poster	poster
potato	potato
pretzel	pretzel
printer	printer
pumpkin	pumpkin
rabbit	rabbit
raccoon	raccoon
racket	racket
radish	radish
ratchet	ratchet
raven	raven
refrigerator	refrigerator
reptile	reptile
rhinoceros	rhinoceros
rifle	rifle
rocket	rocket
rose	rose
ruler	ruler
salad	salad
sandal	sandal
sandwich	sandwich
saucer	saucer
saxophone	saxophone
scale	scale
scarf	scarf
scissors	scissors
scoreboard	scoreboard
scorpion	scorpion
screwdriver	screwdriver
sculpture	sculpture
seafood	seafood
seahorse	seahorse
segway	segway
shark	shark
sheep	sheep
shelf	shelf
shellfish	shellfish
shirt	shirt
shorts	shorts
shotgun	shotgun
shower	shower
shrimp	shrimp
sink	sink
skateboard	skateboard
ski	ski
skirt	skirt
skull	skull
skunk	skunk
skyscraper	skyscraper
snack	snack
snail	snail
snake	snake
snowboard	snowboard
snowman	snowman
snowmobile	snowmobile
snowplow	snowplow
sock	sock
sombrero	sombrero
sparrow	sparrow
spatula	spatula
spider	spider
spoon	spoon
squash	squash
squid	squid
squirrel	squirrel
stairs	stairs
stapler	stapler
starfish	starfish
stethoscope	stethoscope
stool	stool
strawberry	strawberry
stretcher	stretcher
submarine	submarine
suit	suit
suitcase	suitcase
sunglasses	sunglasses
surfboard	surfboard
sushi	sushi
swan	swan
swimwear	swimwear
sword	sword
syringe	syringe
table	table
tableware	tableware
taco	taco
tank	tank
tap	tap
tart	tart
taxi	taxi
tea	tea
teapot	teapot
telephone	telephone
television	television
tent	tent
tiara	tiara
tick	tick
tie	tie
tiger	tiger
tire	tire
toaster	toaster
toilet	toilet
tomato	tomato
tool	tool
toothbrush	toothbrush
torch	torch
tortoise	tortoise
towel	towel
tower	tower
toy	toy
train	train
treadmill	treadmill
tree	tree
tripod	tripod
trombone	trombone
trousers	trousers
truck	truck
trumpet	trumpet
turkey	turkey
turtle	turtle
umbrella	umbrella
unicycle	unicycle
van	van
vase	vase
vegetable	vegetable
vehicle	vehicle
violin	violin
volleyball	volleyball
waffle	waffle
wardrobe	wardrobe
watch	watch
watercraft	watercraft
watermelon	watermelon
weapon	weapon
whale	whale
wheel	wheel
wheelchair	wheelchair
whisk	whisk
whiteboard	whiteboard
willow	willow
window	window
wine	wine
wok	wok
woman	woman
woodpecker	woodpecker
worm	worm
wrench	wrench
zebra	zebra
zucchini	zucchini
